########################################
#              # #                     #
#         ##                           #
#         #     # #          #         #
# #             #    #         #       #
#              #                       #
#          # #   #          #          #
#       #    #    ##                   #
#                          ##          #
#             #              #         #
#        #   #    #       #            #
#         #   #               #        #
#            #      #     #            #
#      # #             #     #         #
#                     #                #
#      #  #    #                       #
#    #           #    #  #             #
#     #                    #           #
#                 #                    #
########################################

0